drawn=çekilmiş
weary=yorgun
stuff=şey madde sayfa
throug=sayesinde
throughout=boyunca,bir yerden bir yere geçmek,süresince
creak=gıcırtı
troug=yalak,oluk
deemed=sayılır
unworthy=değmez
retrieval=geri alma
tedious=sıkıcı
funding=finansman
contemporary=çağdaş
pull=arka çıkma
grant=vermek,hibe
pull strings=torpil yaptırmak
call in favors=iyilik istemek
providing=sağlama
likely=muhtemelen
muck=gübre
satellite=uydu
satellite imaging=uydu görüntüleme
prob=sonda
ladle=kepçe
features=özellikler
further=daha fazla
Preliminaries=hazırlık
topic=kavram
Evaluation=değerlendirme
Influences=etkiler
Trade-Offs=Ödünleşme
Implementation=uygulama
Increased=artan
increment=artır
express=ifade
Improved=gelişmiş
appropriate=uygun
significance=önem
background=geçmiş
computing=hesaplama
Overall=tüm,etraflıca
Produce=üretmek
rather=yerine
because of=nedeniyle
efficiency=verim
Eclectic=seçmeci
markup=biçimleme
purpose=amaç
script=komut dosyası,senaryo
ease=hafifletmek
ease with=kolaylaştırmak
conformance=uyma
ultimate=nihai
simplicity=basitlik
Orthogonality =ortogonallik,diklik
relatively=nispeten
primitive =ilkel
Adequate=yeterli
predefined=önceden tanımlanmış
considerations=hususlar
Identifier=işaretleyici,tanımlayıcı
compound=bileşik 
statements=deyimler
forming=şekillendirme
self-descriptive=kendini açıklayıcı
meaningful=anlamlı
few=daha az
define=tanımlamak
allow=izin vermek
Expressivity=anlatımcılık
convenient=uygun
specifying=belirterek
corrective=düzeltici 
measures=tedbirler
Intercept=kesişmek
Aliasing=örtüşme
Presence =varlık
distinct=ayrı
expressing=ifade
approaches=yaklaşımlar
hence=dolayısıyla
reduced=azaltılmış
particular=belirli
leads=neden olur
Maintaining=bakım
Well-definedness=iyi tanımlama
wide=geniş
range=menzil,alan
precision=kesinlik
definition=tanım
prevalent=yaygın
separate=ayrı
piped=boru,iletilir,taşınır
basis=temel
basis for=temeli
cell=hücre
Assignment=atama 
statements=deyimleri
efficient=etkili
result=sonuç
processing=işlem
fetch=pc'de emirlerin getirilmesi
initialize=başlangıç durumuna getirme(başlatılamıyor)
pointed=işaretlenen
top-down=büyükten-küçüğe
step-wise=adım usulü 
refinement=arıtma(düzeltme)
inheritance=kalıtım
means=araç
extended=genişletilmiş
conveying information=bilgi alışverişi
lexical=sözcük
parse trees=ayrıştırma ağaçları
syntactic structure=sözdizimsel yapı
represent=temsil etmek
Semantics analysis=anlamsal analiz
intermediate*=orta düzey
generetion=üretim
Additional=ilave
image=imaj
executable=Çalıştırılabilir
together=birlikte
linking=yönlendirme
Bottleneck=darboğaz
between=arasında
determines=tanımlama
instructions=komutları,deyimleri
thus=böylece
Pure Interpretation=sade yorumlama
immediately=anında
run-time=çalıştırma
traditional=geleneksel
rare=nadir kullanım
comeback =tekrar
Significant=önemli
interpreter=yorumlayıcı
compromise=uzlaştırıcı(-sağlar)
allows=müsade eden
perl=metin
initial=başlangıç
subsequent=mütaakip,sonraki
widely=yaygın
Preprocessors=önişlemciler
macros=yapı(makro)
expand*=genişletmek
on top of=üst seviyesi
visual=görsel
except=dışında
releated=ilgili,ait komplikasyon
summary=özet
valuable=değişken,değerli
Increase our capacity=kapasitemizi artırır
Major influences=Başlıca etkileri
determinately=belirli olarak
indeed=gerçekten
convincingly=inandırıcı
convinces=ikna
conclusion=sonuç
guess=tahmin
unless=olmadıkça
argue= tışma,savunma(fikir),iddia
discuss=tartışma,görüşmek
kind=tür
care=bakım,özen,ilgi,dikkat
merely=sadece
issue=konu,sorun
frown=kaşlarını çatmak
pretend=numara yapmak
breath=nefes(almak)
observe=gözlemek,izlemek,incelemek,uymak
instead=yerine
engage=bağlamak,tutmak,çekmek
head to one side=başka taraftan
upset=üzgün,sinirli,bozulmuş(duygu)
contradicted=çelişmek
assuming=varsayılayarak
describes=tarif
judgement=yargı
rebute=azarlama
leisurely=acelesiz
intensity=yoğunluk
violently=şiddetli
evasive=kaçamak
basin=havza
poured=döktü
restlessly=huzursuz
moan=inilti
strange=acayip
even=hatta,bile
recede=gerilemek
though=düşünce
rush=acele
jaw=çene
missing=eksik
bound=bağlı,ilişkili
hiss=tıslama
sink=batmak
wander=dolaşmak,wandering=göçebe
aware=farkında
semiconscious=yarı uyanık
fight off=defetmek
shoreline=kıyı
pollute=kirletmek
similar=benzer
as well=de
inland=karada
crops=bitkiler
stunted=bodur
afford=gücü,parası yetmek
either to=birine
couldn't afford=göze alamamak
toward=karşı
hinder=engellemek
deserted=ıssız,terkedilmiş
almost=neredeyse
drown=boğulmak
cacophony=çığlık çığlığa
rub=ovmak
keenly=hevesle
gaze=dik dik bakmak
as=gibi,kadar,iken,bağlaç,olduğu gibi,as,ki,iken,rağmen,karşın,-diği gibi,madem,mademki,-irken
self=kendi,öz,bencil
like=gibi
such=böyle
interconected=birbirine
revisit=tekrar
exploring=keşfetmek
crucisal=çok önemli
might=kuvvet,mümkünlük,-ebilmek
as one unit=tek bir birim olmak
ultimately=eninde sonunda
confidence=güven
fading=solma
fad=tuhaflık
whether=olup olmadığı
innater=doğuştan
necessarily=zorunlu olarak
indescrible=tarfisiz
experiance=deneyim
implode=içeriye patlamak
innurable=sayısız
impresion=izlenim
intellect=akıl
susceptiple=duyarlı
shall=-ecek,-acak,-meli
occasion=fırsat,durum
present=sunmak,tanıtmak,bulunmak,mevcut
established=kurulmuş,belirlenmiş
put=koymakisabit,hamle,yatırma
goel=hedef
obvious=açık
artifacts=eserler
clumps=kümeleri
wortless=değersiz
unless=olmadıkça
warn(ing)=uyarmak,tehlike
territory=bölge
fact=gerçek
decinition=tanım
familiar=tanıdık
nebulous=bulutsu,şüpheli
tricky=hileli
comprehend=anlamak
grasp=kavramak
falls=düşme
hackneyed=kaşarlanmış,basmakalıp
judget=karar
reason=neden,sebeb,akıl
interacts=etkileşim
place=yer
during=sırasında
distand=uzak
output=çıktı,üretim
unshurable=paylaşılamaz
essential=gerekli
Sophistication=çok yönlülük
Descendants=torun
Effort=çaba
Combining=birleştirme
Markup=biçimlendirme
Invariants=değişmezler
deficiencies=eksiklikler
Conditional=şartlı
pseudo=sözde
acces=erişim
left=arta kalan
unreliable=güvenilmez
concern=endişe
impact=darbe,etki
decimal=ondalık
overview=genel bakış
unique=benzersiz
feely=duygusal
compared=karşılaştırıldığında
regard=saymak
entertainment=eğlence,ağırlama,alem
cope=başa çıkmak
split=bölmek
linear=lineeridoğrusal
fairly=oldukça,epeyce
author=yazar
sequence=sıra
distinction=ayrım,fark
arise=ortaya 
else=başka
offer=teklik
trospective=dönük
retrospective=geriyedönük
discoveries=keşifler
useful=kullanışlı
govern=yönetmek
case=dava
provable=kanıtlanabilir
cover=kapak
covered=kaplı
realm=diyar
schism=bölünme
behaviorists=danranışçılar
inperfectly=eksik
introspection=içgözlem
measurable=ölçülebilir
obligated=mecbur
fascinating=büyüleyici
extreme=aşırı
void=geçersiz
avoid=önlemek
Distributed=dağıtılmış
Independent=bağımsız
evolved=gelişdi
Explicit=açık,belli
declarations=bildirimler
handling=idare
additions=eklemeler
ditto=aynen
Representing=temsil
Pioneered=öncü
dialects=lehçeler
mid(dle)=orta
Extensive=geniş
scope(ing)=kapsam
entities=kuruluşlar
common=ortak
met=araya gelmek,araya
dependent=bağımlı
Although=rağmen
enthusiastic=hevesli
especially=özellikle
Lack=eksiklik
less=eksik
manufacturers=üreticiler
among=arasında,arasına
concurrency=eşzamanlı
switch=priz,değiştirilebilir
allocation=tahsis
dimensions=boyutlar
Contributions=katılımlar
Coroutines=eşyordamlar
superset=üst(kümesidir)
widespread=yaygın
spread=yaymak
prolog=önsöz
suffered=acı
Promoted=prometed
Facilities=tesisler
Facilities=onaylı
delegates=temsilci
enthusiasts=meraklılar
elegant=şık
purely=sadece
denoted=ifade
Gained=ganimet,kazanılan
joint=ortak 
venture=girişim
tuples=dizilerini
hashes=sağlama
extendable=uzatılabilir
replacement=yedek
extensible=genişletilebilir
sheet=levha
enacted=yürürlük
Intro(duction)=giriş
Attribute=nitelik
alphabet=alfabe
Recognizers=tanıyıcı
formal=biçimsel
meant=demek
Fundamentals=temelleri
enclosed=kapalı,ekli
angle=açı
brackets=parantez
bracket=dirsek
finite=sınırlandırmak
derivation=türetme
sentential=cümlesel
leftmost=soldaki
each=her
Ambiguity=belirsizlik
indicate=belirtmek
precedence=öncelik
Associativity=birleşebilirlik
predicates=yüklemler
consistency=tutarlılık
synthesized =sentezlenen
intrinsic=gerçek
bottom=alt
order=sıra,düzen,sipariş
notation =not etme,gösterim
several=birkaç
Correctness=doğruluk
proofs=deliller
inconsistencies=tutarsızlıklar
idealized=idealize
informally=gayri,kayıt dışı
Extremely=son derece
Denotational=denotasyonel
current=akım
operands=işlenenler
Pretest=öntest
rigor=titizlik
prove=kanıtlamak
assertions=iddialar
Axiomatic=aksiyom
weakened=zayıflamış
weakest=zayıf
precondition=ön koşul
postcondition=son şart
precondition=ön koşul
Consequence=sonuç
satisfied=memnun
framework=yapı,iskelet
usefulness=kullanışlılık
equivalent=eşdeğer
suited=uygun,ideal
descent=iniş,türeyiş
regardless=ne olursa olsun
Nearly=neredeyse
matcher=eşleştirici
Identifies=tanımlar,belirtir
associated=ilişkili
naive=saf
transitions=geçişler
digit=basamak
lookup=arama
diagnostic=tanı
trace=iz
unambiguous=kesin
inefficient=verimsiz
lookahead=ilerlemeiileri yönü
Pairwise=büküm
Disjointness=aykırılık
outer=dış,harici
intuition=sezgi
handles=kolları
pruning=budama
phrase=ifade
corresponding=uyan,yerini tutan,eş
insight=kavrama
components=bileşenleri
also=ayrıca
in most=çoğu
which means=bunun anlamı
context=bağlam
remaining=kalan
considered=kabul
however=ancak,halbuki
appearance=görünüm
elsewhere=başka yerde
large number=çok sayıda
include=içerme
commonly=çoğunlukla
explicitly=açıkça
instantiations=örnekleme
appears=görüntülenir
aliases=takma
branch=şube
holistic=bütünsel
mental=zihinsel
aspects=yönleri
particular=belirli
fieldwork=saha
immerse=daldırmak
strive=çabalamak
introspection=iç gözlem
insightly=anlayış
variely=çeşitlilik
thump=başparmak
perils=tehlikeleri
examining=incelenmesi
rapid=hızlı
decivise=belirleyici
reject=reddetmek
valid=geçerli
inquiry=soruşturma
crackpot=çılgın
noted=ünlü
all along=boyunca
huff=dargın
swallowed=yutulmak
ebb=alçalmak
dramp=nemli
pant=özlemek,hızlı solumak
swivel=çevrilmiş
flay=soymak
reddish=kırmızımsı
pith=ilik
fleck=leke
splotcity/ies=lekeler
ooze=sızmak
veined=damarlı
covered=kapaklı
membrane=zar hücre
bone=kemik
vanish=gözden kaybolmak
loose=gevşek
bitter=acı
acrid=buruk
cough=öksürük
hunch=çömelmek
hunched over=kamburlaşma
webbed=perdeli
Relational=ilişkisel
fundamental=temel
essence=öz,esas
imperative=zorunluluk
consist=oluşturmak
unary=birli
ternary=üçlü
adjacent=komşu,bitişik
overridden=geçersiz
coercion=zorlama
